111111111111111111111111111111
1P0C01011100101000100000000001
10000010000000000000C000101001
100000000000000001C001C0000001
100100C0100C000000C00000000001
10010000011CC000110C0110001001
1C00000010000C100C100000000C01
100000000110001001000001001011
10000100001101000011000C010001
100C01C000010010000001C1000001
100100100010000000110101100111
1000000000001010CC010100100001
10000000000000001010000C110101
1000000010C0000100C00001000001
101100010010000000100100110101
1010C10100C00010000C0100100101
101001100C11C00000011010000C01
1001000110100100010C0000000001
10C1000000101100001010001000E1
111111111111111111111111111111
