111111111111111111111111111111
1P01001000000000001C0000110001
100000000010110001C01110001111
100100000010000000100C00000001
110100100000000000110101100101
100CC001000100000011000C000001
10001000000C0C01C0000000011001
100000000001000010000010010011
1C1000000010000000001011010001
11000C01000CC00000C00000C00011
1010000000000100111C1010C10001
10110000110C010100000010000001
101001000000011C01C00000010001
10000C011100010001101101000001
100100000000C000C000000C110C11
101010100000001100000100000101
1100000101010000000C0000000001
1100C00100C1001001011110000001
100001C00100010001C110010C10E1
111111111111111111111111111111
