1111111111
1C000000C1
1P000000C1
1C000000C1
1000000001
1C0000E001
1000000001
1C000C00C1
1C00000001
1111111111
