11111111111111111111111111111
1P0010000000000C10000C1000001
10100100001111111110010000001
1010011110101010001001C000001
101000000000C00000E0001111001
10C10000000000000011100000001
11111111111111111111111111111
