11111111111111111111111111111111111111111111111111
1P00010010001010000001011000C001110011000100010001
10100010001000000001000000110000100000000000000001
100001010000001000101000000010101000001C0010000111
10000010000100000000100010001101000000001000000101
10000101000000111000100010000010100010010011010001
10000110011000100000100100101010000000000000110001
11111010000000000101010000100000000000011001010011
10000001101000111000010001000010100001000011011011
11000000000010010000010001000000100010000000011101
10000000011001100100010000110100011000010010000001
10011100001110010000000011100001010001000011001011
10111101001010100010000001000000000000111001010001
10001000000100000001101101000010001010000101010001
10000010101000111001000100101000000101000000000011
10000000100000010000000000000010010000000010000001
10000011000100001100100C10110000010000000101001001
11000101110001100000000001000001110100000000101001
10000001000001001000010100000000001111111000000101
10000010100000000000110100001000100100101010000111
11010001011000110011000110101000000101011001001001
10010001100010010000010001000100000010000000001011
101000010010001100000101000000100111001C0110010001
11000001110010100100011010100000000101110000100111
10000000000100010000100000101000100001100010110001
11000101000000100000010000010000010100001100001001
11101011111001000010000001001010010000100001000001
11000000101101001100001110100101001100000110110111
100001000110100000011010000101000110C11111000111E1
11111111111111111111111111111111111111111111111111
